R 1920 1080

NO textures/texture1.xpm
SO textures/texture2.xpm
WE textures/texture3.xpm
EA textures/texture4.xpm
S textures/dog.xpm


C 20,24,20
F 48,48,48




11111111111111111111111111111
10000000001100000000000000021
10110000011100000002000010001
10010020000000000000000010001
10110000011100000000000010001
10000000001100000111011110001
11110111111111011100000010001
11110111111111011101010010001
11000000110101011100000010021
10000002000000001100000010001
10000000000000001101010010001
11020000110101000000000000001
11110111110101000000000000001
10000000001100000100000010001
10000000000000001010000101001
10000000001200010001010001001
10000000001101000000N00000001
10000000000100020001010000001
10020000001100000000000000001
10110000011100000000000010001
10010000000000000200000010001
10110000011100000000000010001
10000000001120000111011110001
11110111111111011100000010001
11110111111111011101010010001
11000000110101011100000010001
10000200000000001100000010001
12000000000000001101010010001
11000000110101000000000000001
11110111110101000000000000001
10000000001100000100000010001
10002000000000001010000101001
10200000201000010001010221001
10000000001101000000000000001
10000200000100000001010000001
11111111111111111111111111111
